00,00,00,00,00,00,00,00,00,00
00,32,00,00,00,00,00,00,00,00
00,11,00,00,14,13,13,00,33,00
00,12,14,00,12,13,12,00,12,00
63,63,63,63,63,63,63,63,63,63