#
0,32,0,0
1,2,2,3
4,5,5,6
7,8,8,9
#
0,0,1,3,0
0,1,5,5,3
0,4,5,5,6
0,7,8,8,9
#
0,0,32,0,0
0,1,2,2,3
0,4,5,5,6
0,7,8,8,9
#
0,0,0,0,0
0,1,2,2,3
0,4,5,5,6
0,7,8,8,9
#
0,0,33,0,0
0,1,2,2,3
0,4,5,5,6
0,7,8,8,9


