00,00,00,00,00,00,00,00,00
00,00,32,00,00,00,33,00,00
00,13,13,13,13,13,13,13,00
00,10,10,10,10,10,10,10,00
00,10,10,10,10,10,10,10,00
63,63,63,63,63,63,63,63,63