00,00,00,00,00,00,00,00,00,00
00,00,00,00,00,00,00,00,33,00
00,32,14,14,12,13,00,13,14,00
00,13,12,12,13,12,00,13,11,00
63,63,63,63,63,63,63,63,63,63