00,00,00,00,00,00,00,00,00,00,00,00,00,00,00,00
00,00,32,00,00,00,00,32,00,00,00,00,00,33,00,00
00,01,02,02,00,00,02,02,02,00,00,02,02,02,03,00
00,04,05,05,00,00,05,05,05,00,00,05,05,05,06,00
00,07,08,08,00,00,08,08,08,00,00,08,08,08,09,00
00,00,00,00,00,00,00,00,00,00,00,00,00,00,00,00