00,00,00,00,00,00,00,00,00,00,00,00,00,00,00,00,00,00,00,00
00,00,00,00,00,00,00,00,00,00,00,00,11,00,00,00,00,00,00,00
00,00,00,00,00,00,00,00,11,11,00,00,00,00,00,00,00,00,00,00
00,00,00,00,00,00,00,12,12,11,00,00,00,00,00,00,00,00,00,00
00,00,00,00,00,00,13,12,11,00,00,00,00,00,00,00,00,00,00,00
00,32,00,00,00,13,12,12,00,00,00,00,63,00,00,00,00,00,33,00
00,13,13,13,13,13,13,13,13,13,13,13,13,13,13,13,13,13,13,00
00,13,13,13,13,13,13,13,13,13,13,13,13,13,13,13,13,13,13,00
63,63,63,63,63,63,63,63,63,63,63,63,63,63,63,63,63,63,63,63