61,61,61,61,61,61,61,61,61,61,61,61,61,61,61,61,61,61,61,61,61,61,61,61,61,61,61,61,61,61,61,61,61,61,61,61,61,61,61,61,61,61,61,61,61,61,61,61,61,61,61,61,61,61,61,61,61,61,61,61,61,61,61,61,61,61,61,61,61,61,61,61,61,61,61,61,61,61,61,61,61,61,61,61,61,61,61,61,61,61,61,61,61,61,61,61,61,61,61,61
61,61,61,61,61,61,61,61,61,61,61,61,61,61,61,61,61,61,61,61,61,61,61,61,61,61,61,61,61,61,61,61,61,61,61,61,61,61,61,61,61,61,61,61,61,61,61,61,61,61,61,61,61,61,61,61,61,61,61,61,61,61,61,61,61,61,61,61,61,61,61,61,61,61,61,61,61,61,61,61,61,61,61,61,61,61,61,61,61,61,61,61,61,61,61,61,61,61,61,61
61,61,61,61,61,61,61,61,61,61,61,61,61,61,61,61,61,61,61,61,61,61,61,61,61,61,61,61,61,61,61,61,61,61,61,61,61,61,61,61,61,61,61,61,61,61,61,61,61,61,61,61,61,61,61,61,61,61,61,61,61,61,61,61,61,61,61,61,61,61,61,61,61,61,61,61,61,61,61,61,61,61,61,61,61,61,61,61,61,61,61,61,61,61,61,61,61,61,61,61
61,61,61,61,61,61,61,61,61,61,61,61,61,61,61,61,61,61,61,61,61,61,61,61,00,61,61,00,00,61,61,61,61,61,61,61,61,61,61,61,61,61,61,61,61,61,00,61,61,61,61,61,61,61,61,61,61,61,61,61,61,61,61,61,61,61,61,61,61,61,61,61,61,61,61,61,61,61,00,61,61,61,61,61,61,61,61,00,00,61,61,61,61,61,61,61,61,61,61,61
61,32,61,61,61,61,61,61,61,61,61,61,61,61,61,61,61,61,61,61,61,61,61,00,00,61,61,00,00,61,61,00,61,61,61,00,61,61,61,61,61,61,61,61,61,00,00,61,61,61,61,61,61,61,61,61,61,61,61,61,61,61,61,61,61,61,61,61,61,61,61,61,00,61,61,61,61,00,00,61,61,61,61,00,61,61,00,00,00,00,61,61,61,61,61,61,61,61,61,61
61,00,61,61,00,61,00,61,00,00,00,61,61,61,61,61,61,61,61,61,61,00,00,00,00,61,61,00,00,61,61,00,34,00,00,00,61,61,61,61,61,61,61,61,00,00,00,61,61,00,00,61,61,61,61,61,61,61,61,61,61,61,61,61,61,61,00,00,61,00,61,00,00,61,00,61,00,00,00,61,61,61,00,00,61,00,00,00,00,00,00,61,61,61,61,61,61,61,61,61
61,00,61,61,00,61,00,00,00,00,00,61,00,61,61,61,61,61,61,61,00,00,00,00,00,61,61,00,00,61,61,00,00,00,00,00,61,00,00,61,00,00,61,00,00,00,00,61,61,00,00,00,61,61,00,61,61,61,61,61,61,61,00,61,61,00,00,00,61,00,61,00,00,61,00,61,00,00,00,61,61,61,00,00,61,00,00,00,00,00,00,61,61,61,00,00,61,61,33,61
61,00,61,61,00,61,00,00,00,00,00,61,00,61,00,61,00,61,00,00,00,00,00,00,00,61,61,00,00,61,61,00,00,00,00,00,61,00,00,00,00,00,00,00,00,00,00,61,61,00,00,00,61,61,00,00,34,00,61,61,00,61,00,61,00,00,00,00,61,00,61,00,00,61,00,61,00,00,00,61,61,61,00,00,61,00,00,00,00,00,00,61,61,61,00,00,61,61,00,61
60,60,60,60,60,60,60,60,60,60,60,60,60,60,60,60,60,60,60,60,60,60,60,60,60,60,60,60,60,60,60,60,60,60,60,60,60,60,60,60,60,60,60,60,60,60,60,60,60,60,60,60,60,60,60,60,60,60,60,60,60,60,60,60,60,60,60,60,60,60,60,60,60,60,60,60,60,60,60,60,60,60,60,60,60,60,60,60,60,60,60,60,60,60,60,60,60,60,60,60