00,00,00,00,00,00,00,00,00,00
00,00,00,00,00,00,00,00,33,00
00,00,00,00,00,00,00,13,12,00
00,00,00,00,00,00,12,12,13,00
00,00,00,13,00,12,11,14,14,00
00,32,11,11,11,11,13,13,14,00
00,11,11,12,11,11,13,11,11,00
00,12,13,12,12,14,11,12,13,00
00,13,13,14,12,14,12,13,11,00
00,12,14,13,13,11,13,12,12,00
00,13,12,13,14,13,13,11,11,00
00,14,13,12,14,12,11,14,11,00
63,63,63,63,63,63,63,63,63,63