00,00,00,00,00,00,00,00,00,00
00,32,00,00,00,00,00,00,00,00
00,14,00,00,00,00,00,00,00,00
00,12,13,00,00,00,00,00,00,00
00,14,12,14,00,00,00,00,33,00
00,13,11,14,11,14,00,11,11,00
63,63,63,63,63,63,63,63,63,63