00,00,00,00,00,00,00,00,00,00
00,32,00,00,00,00,00,00,00,00
00,12,00,00,00,00,00,00,00,00
00,11,00,00,00,00,00,00,00,00
00,11,00,12,00,13,00,00,00,00
00,13,00,14,00,12,00,00,00,00
00,11,00,14,00,12,00,12,33,00
00,14,00,12,00,11,00,12,12,00
00,12,00,11,00,11,00,14,11,00
63,63,63,63,63,63,63,63,63,63