00,00,00,00,00,00,00,00,00,00,00
00,00,32,00,00,00,00,00,33,00,00
00,12,12,12,12,00,12,12,12,12,00
00,12,12,12,12,00,12,12,12,12,00
00,12,12,12,12,00,12,12,12,12,00
63,63,63,63,63,63,63,63,63,63,63