00,00,00,00,00,00,00,00,00,00
00,00,00,00,00,00,00,00,00,00
00,32,12,00,00,00,00,00,00,00
00,13,13,13,00,00,14,00,33,00
00,14,11,13,12,11,14,13,12,00
00,14,11,14,11,13,13,13,13,00
63,63,63,63,63,63,63,63,63,63