00,00,00,00,00,00,00,00,00,00,00,00,00,00,00,00,00,00,00,00,00,00,00,00,00,00,00,00,00,00
00,00,00,00,00,00,00,00,00,00,00,00,00,00,00,00,00,00,00,00,00,00,00,00,00,00,00,00,00,00
00,00,00,00,00,00,00,00,00,00,00,00,00,00,00,00,00,00,00,14,00,00,00,00,00,00,00,00,00,00
00,00,00,00,00,00,00,00,00,00,00,00,00,00,00,13,00,12,12,13,00,00,00,13,00,00,00,00,00,00
00,00,00,00,00,00,00,00,00,00,00,32,13,00,00,14,00,13,11,12,00,14,12,13,00,13,00,00,00,00
00,00,00,00,00,00,00,11,13,14,00,11,14,12,00,11,00,13,13,11,00,11,11,11,00,11,14,00,33,00
00,32,00,00,32,11,00,13,13,14,00,11,11,13,00,11,00,13,14,12,00,12,12,13,00,13,13,11,12,00
00,11,12,00,14,12,00,13,11,13,00,13,13,12,00,11,00,13,14,12,00,13,13,11,00,11,13,12,13,00
00,13,14,00,13,11,00,12,11,13,00,63,63,63,63,63,63,63,63,63,63,63,63,63,63,63,63,63,63,63
00,12,13,00,12,13,00,11,11,12,00,12,00,00,00,00,00,00,00,00,00,00,00,00,00,00,00,00,00,00
63,63,63,63,12,12,00,11,14,14,00,13,00,00,00,00,00,00,00,00,00,00,00,00,00,00,00,00,00,00
00,00,00,00,11,12,00,14,11,13,00,13,00,00,00,00,00,00,00,00,00,00,00,00,00,00,00,00,00,00
00,00,00,00,12,14,00,12,14,14,00,13,00,00,00,00,00,00,00,00,00,00,00,00,00,00,00,00,00,00
00,00,00,00,12,13,00,13,14,13,00,12,00,00,00,00,00,00,00,00,00,00,00,00,00,00,00,00,00,00
00,00,00,00,63,63,63,63,63,63,63,63,00,00,00,00,00,00,00,00,00,00,00,00,00,00,00,00,00,00
00,00,00,00,00,00,00,00,00,00,00,00,00,00,00,00,00,00,00,00,00,00,00,00,00,00,00,00,00,00
00,00,00,00,00,00,00,00,00,00,00,00,00,00,00,00,00,00,00,00,00,00,00,00,00,00,00,00,00,00