00,00,00,00,00,00,00,00,00,00,00,00,00,00,00,00,00
00,00,00,00,00,00,00,00,00,00,00,00,00,00,00,33,00
00,00,00,00,00,00,00,00,00,00,00,00,00,00,00,11,00
00,00,00,00,00,00,11,00,32,00,00,00,00,11,11,11,00
00,00,00,00,11,00,11,11,11,00,11,00,00,11,11,11,00
00,00,00,11,11,00,11,11,11,00,11,00,00,11,11,11,00
00,32,11,11,11,00,11,11,11,00,11,00,00,11,11,11,00
00,11,11,11,11,00,11,11,11,00,11,00,00,11,11,11,00
00,11,11,11,11,00,11,11,63,63,63,63,63,63,63,63,63
00,11,11,11,11,00,11,11,11,00,00,00,00,00,00,00,00
00,11,11,11,11,00,11,11,11,00,00,00,00,00,00,00,00
63,63,63,63,63,63,63,63,63,00,00,00,00,00,00,00,00