00,00,00,00,00,00,00,00,00,00,00,00,00,00,00,00,00
00,32,00,00,00,00,00,00,00,00,00,00,00,00,00,33,00
00,11,00,00,00,00,00,00,32,00,00,00,00,00,14,13,00
00,11,00,13,00,13,14,11,14,00,11,12,14,14,13,11,00
63,63,63,63,63,63,63,63,63,63,63,63,63,63,63,63,63