00,00,00,00,00,00,00,00,00,00,00,00,00
00,00,32,00,00,00,00,00,00,00,00,00,12
00,00,13,00,00,00,33,11,00,14,13,11,11
11,14,00,14,13,00,11,12,11,14,14,12,11
13,00,00,11,13,12,14,11,12,14,14,00,00
11,13,13,14,13,13,12,11,00,00,14,13,13
13,14,11,11,12,00,63,63,63,63,63,63,63
63,63,00,00,00,00,00,00,00,00,00,00,00
00,00,00,00,00,00,00,00,00,00,00,00,00