00,00,00,00,00,00,00,00,00,00,00,00,00
00,00,00,00,32,00,00,00,00,00,00,00,00
00,32,00,00,12,00,00,00,00,00,00,00,00
00,12,00,11,11,00,00,00,00,00,00,00,00
00,14,12,12,11,00,12,00,13,00,00,00,00
00,11,12,14,13,00,14,00,12,00,00,00,00
00,13,12,11,11,00,14,00,12,00,12,33,00
63,63,63,63,14,00,12,00,11,00,12,12,00
00,00,00,00,12,00,11,00,11,00,14,11,00
00,00,00,00,63,63,63,63,63,63,63,63,63