00,00,00,00,00,00,00,00,00,00,33,00,00
32,00,11,13,00,00,14,13,14,11,00,00,14
14,11,13,00,00,14,13,11,11,00,00,00,00
00,00,00,00,11,11,00,00,00,00,00,00,00
33,00,00,00,00,00,00,00,00,00,14,00,00
00,00,00,00,00,11,13,12,00,00,32,00,14
00,14,13,11,12,00,00,12,13,12,11,13,14
12,13,00,00,12,11,11,11,14,13,14,11,00
00,12,12,12,12,11,14,13,14,00,00,14,11
14,13,13,11,12,12,00,00,12,14,13,12,13
12,14,12,00,00,13,11,13,12,11,12,13,14
00,00,63,63,63,63,63,63,63,63,00,00,00