00,00,00,00,00,00,00,00,00,00,00,00,00,00,00,00,00
00,00,00,00,00,00,00,00,00,00,00,00,00,00,00,00,00
00,32,00,00,00,00,14,00,32,00,00,00,00,00,00,00,00
00,13,00,13,00,14,13,12,14,00,00,00,00,00,00,00,00
00,14,11,11,11,13,14,12,12,13,00,00,00,00,00,00,00
00,14,14,11,12,12,11,12,14,12,14,00,00,00,00,33,00
63,63,63,63,63,63,63,63,13,11,14,11,14,00,11,11,00
00,00,00,00,00,00,00,00,63,63,63,63,63,63,63,63,63