00,00,00,00,00,00,00,00,00,00,00,00,00
00,00,00,00,32,00,00,00,00,00,00,00,00
00,32,00,12,11,00,00,00,00,00,00,00,00
00,11,00,13,11,00,00,00,00,00,00,00,00
00,14,00,14,11,00,00,00,00,00,00,00,00
00,11,00,13,12,00,00,11,00,00,00,33,00
00,13,00,13,11,00,00,14,14,00,00,12,00
63,63,63,63,13,00,00,12,14,13,13,13,00
00,00,00,00,11,00,00,14,14,12,14,11,00
00,00,00,00,63,63,63,63,63,63,63,63,63